Charizard – Foc / Volador  
Arcanine – Foc  
Blastoise – Aigua  
Vaporeon – Aigua  
Greninja – Aigua / Siniestre  
Jolteon – Elèctric  
Magnezone – Elèctric / Acer  
Togedemaru – Elèctric / Acer  
Lapras – Aigua / Gel  
Froslass – Gel / Fantasma  
Muk – Verí  
Roserade – Plantes / Verí  
Gengar – Fantasma / Verí  
Venusaur – Plantes / Verí  
Decidueye – Plantes / Fantasma  
Scizor – Insecte / Acer  
Volcarona – Insecte / Foc  
Tyranitar – Roca / Siniestre  
Garganacl – Roca / Acer  
Garchomp – Terra / Drac  
Dugtrio – Terra  
Dragonite – Drac / Volador  
Dragapult – Drac / Fantasma  
Chandelure – Fantasma / Foc  
Mimikyu – Fantasma / Fada  
Talonflame – Foc / Volador  
Corviknight – Volador / Acer  
Lucario – Lluita / Acer  
Metagross – Psíquic / Acer  
Sylveon – Fada  
Gardevoir – Psíquic / Fada
